F 255,0,0
C 0,0,255

NO assets/eagle.png
EA assets/mossy.png
SO assets/red_brick.png
WE assets/wood.png

1111111111111111111
1001001001001001001
1001001001001001001
1001001001001001001
1000000000000000001
1000000000000000001
1000011111111000001
111100000W00 001111
1000000101010000001
1111111111111111111

