F 255,0,0
C 0,0,255

NO assets/eagle.png
EA assets/mossy.png
SO assets/red_brick.png
WE assets/wood.png

       111111111111111111
1111111111111110101
1001001001001001001
1001001001001001001
1001001001001001001
1000000011100000001
100000001 100000001
10000111111110000011
111100000W0000111001
10000001010100000011
1111111111111111111
